S.##.....T
#T##..###.
#.###E###E
#H.E..###.
###T#####G
